B, _, _, _, _, _, _, B, _, _, _, _, B, _, _, _, _, _, _, B, 
_, _, _, _, _, _, _, _, _, _, _, _, _, _, _, _, _, _, _, _, 
_, _, _, _, _, _, _, _, _, _, _, _, _, _, _, _, _, _, _, _, 
_, _, _, _, _, _, _, _, _, _, _, _, _, _, _, _, _, _, _, _, 
_, _, _, _, _, _, _, _, _, _, _, _, _, _, _, _, _, _, _, _, 
_, _, _, W, _, _, _, _, _, _, _, _, _, _, _, _, W, _, _, _, 
_, _, _, W, _, _, _, _, _, _, _, _, _, _, _, _, W, _, _, _, 
_, _, _, W, _, _, _, _, _, _, _, _, _, _, _, _, W, _, _, _, 
_, _, _, W, _, _, _, _, _, _, _, _, _, _, _, _, W, _, _, _, 
_, _, _, W, _, _, _, _, _, _, _, _, _, _, _, _, W, _, _, _, 
_, _, _, W, _, W, W, W, _, _, _, W, W, W, _, _, W, _, _, _, 
_, _, _, W, _, _, _, _, _, _, _, _, _, _, _, _, W, _, _, _, 
_, _, _, W, _, _, _, _, _, _, _, _, _, _, _, _, W, _, _, _, 
_, _, _, W, _, _, _, _, _, _, _, _, _, _, _, _, W, _, _, _, 
_, _, _, W, _, _, _, _, _, _, _, _, _, _, _, _, W, _, _, _, 
_, _, _, _, _, _, _, _, _, _, _, _, _, _, _, _, _, _, _, _, 
_, _, _, _, _, _, _, _, _, _, _, _, _, _, _, _, _, _, _, _, 
_, _, _, _, _, _, _, _, _, _, _, _, _, _, _, _, _, _, _, _, 
_, _, _, _, _, _, _, _, _, _, _, _, _, _, _, _, _, _, _, _, 
B, _, _, _, _, _, _, B, _, _, _, _, B, _, _, _, _, _, _, B, 
